11111111111111111111
10C001000000000001E1
10001C10000000000001
100P0C00000000000001
11111111111111111111
