111111111111111
10010000P000001
100000111110001
100011E000000C1
100000111100001
111111111111111