11111111111111111111111111111111111
100001000000000P0100000000000000001
10001E100000000C0000000000000000001
10000000000000000000000000000000001
11111111111110011111111111111111111
1C010000000010010000000000000000001
11010000000010010000000000000000001
11011111111111000000001111111111001
11100000000000111111110000000000011
11101111111111111111110111111111111
111000000000C0000000000000000000001
11111111111111111111111111111111111
